xxxxxxxxxxxxxx
x  x    k    x
x  x         x
x xxx x   u  x
x    x       x
x x  x  x    x
x            x
x  x  x   xxxx
x x   x   u  o
xxxxxxxxxxxxxx
