xxxxxxxxxxxxxx
x  x    k    x
x  x  xxx x  x
x xxx   x x  x
x    x  x x  x
xxx  x xx x  x
x       xxx  x
xx x xx   xxxx
x  x  x   u  o
xxxxxxxxxxxxxx
